rectangle
10 5
1 1 2 0x00FF0000
2 2 2 0x00FF0000
0 0 2 0xFF000000
3 2 2 0x00FF0000
4 2 2 0x00FF0000