./assets/textures/platform.png
hexagon
10 8
0 0 1 0xFFA50000
1 0 1 0xFFA50000
2 0 1 0xFFA50000
3 0 1 0xFFA50000
4 0 1 0xFFA50000
5 0 1 0xFFA50000
6 0 1 0xFFA50000
7 0 1 0xFFA50000
8 0 1 0xFFA50000
9 0 1 0xFFA50000
0 1 1 0xFFA50000
1 1 1 0xFFA50000
2 1 1 0xFFA50000
3 1 1 0xFFA50000
4 1 1 0xFFA50000
5 1 1 0xFFA50000
6 1 1 0xFFA50000
7 1 1 0xFFA50000
8 1 1 0xFFA50000
9 1 1 0xFFA50000
0 2 1 0xFFA50000
1 2 1 0xFFA50000
2 2 1 0xFFA50000
3 2 1 0xFFA50000
4 2 1 0xFFA50000
5 2 1 0xFFA50000
6 2 1 0xFFA50000
7 2 1 0xFFA50000
8 2 1 0xFFA50000
9 2 1 0xFFA50000
0 3 1 0xFFA50000
1 3 1 0xFFA50000
2 3 1 0xFFA50000
3 3 1 0xFFA50000
4 3 1 0xFFA50000
5 3 1 0xFFA50000
6 3 1 0xFFA50000
7 3 1 0xFFA50000
8 3 1 0xFFA50000
9 3 1 0xFFA50000
0 4 1 0xFFA50000
1 4 1 0xFFA50000
2 4 1 0xFFA50000
3 4 1 0xFFA50000
4 4 1 0xFFA50000
5 4 1 0xFFA50000
6 4 1 0xFFA50000
7 4 1 0xFFA50000
8 4 1 0xFFA50000
9 4 1 0xFFA50000
0 5 1 0xFFA50000
1 5 1 0xFFA50000
2 5 1 0xFFA50000
3 5 1 0xFFA50000
4 5 1 0xFFA50000
5 5 1 0xFFA50000
6 5 1 0xFFA50000
7 5 1 0xFFA50000
8 5 1 0xFFA50000
9 5 1 0xFFA50000
0 6 1 0xFFA50000
1 6 1 0xFFA50000
2 6 1 0xFFA50000
3 6 1 0xFFA50000
4 6 1 0xFFA50000
5 6 1 0xFFA50000
6 6 1 0xFFA50000
7 6 1 0xFFA50000
8 6 1 0xFFA50000
9 6 1 0xFFA50000
0 7 1 0xFFA50000
1 7 1 0xFFA50000
2 7 1 0xFFA50000
3 7 1 0xFFA50000
4 7 1 0xFFA50000
5 7 1 0xFFA50000
6 7 1 0xFFA50000
7 7 1 0xFFA50000
8 7 1 0xFFA50000
9 7 1 0xFFA50000