rectangle
10 8
0 0 2 0xFF0000FF
1 0 2 0xFF0000FF
2 0 2 0xFF0000FF
3 0 2 0xFF0000FF
4 0 2 0xFF0000FF
5 0 2 0xFF0000FF
6 0 2 0xFF0000FF
7 0 2 0xFF0000FF
8 0 2 0xFF0000FF
9 0 2 0xFF0000FF
0 1 2 0x00FF00FF
1 1 2 0x00FF00FF
2 1 2 0x00FF00FF
3 1 2 0x00FF00FF
4 1 2 0x00FF00FF
5 1 2 0x00FF00FF
6 1 2 0x00FF00FF
7 1 2 0x00FF00FF
8 1 2 0x00FF00FF
9 1 2 0x00FF00FF
0 2 2 0x0000FFFF
1 2 2 0x0000FFFF
2 2 2 0x0000FFFF
3 2 2 0x0000FFFF
4 2 2 0x0000FFFF
5 2 2 0x0000FFFF
6 2 2 0x0000FFFF
7 2 2 0x0000FFFF
8 2 2 0x0000FFFF
9 2 2 0x0000FFFF
0 3 2 0xFF0000FF
1 3 2 0xFF0000FF
2 3 2 0xFF0000FF
3 3 2 0xFF0000FF
4 3 2 0xFF0000FF
5 3 2 0xFF0000FF
6 3 2 0xFF0000FF
7 3 2 0xFF0000FF
8 3 2 0xFF0000FF
9 3 2 0xFF0000FF
0 4 2 0x00FF00FF
1 4 2 0x00FF00FF
2 4 2 0x00FF00FF
3 4 2 0x00FF00FF
4 4 2 0x00FF00FF
5 4 2 0x00FF00FF
6 4 2 0x00FF00FF
7 4 2 0x00FF00FF
8 4 2 0x00FF00FF
9 4 2 0x00FF00FF
0 5 2 0x0000FFFF
1 5 2 0x0000FFFF
2 5 2 0x0000FFFF
3 5 2 0x0000FFFF
4 5 2 0x0000FFFF
5 5 2 0x0000FFFF
6 5 2 0x0000FFFF
7 5 2 0x0000FFFF
8 5 2 0x0000FFFF
9 5 2 0x0000FFFF
0 6 2 0xFF0000FF
1 6 2 0xFF0000FF
2 6 2 0xFF0000FF
3 6 2 0xFF0000FF
4 6 2 0xFF0000FF
5 6 2 0xFF0000FF
6 6 2 0xFF0000FF
7 6 2 0xFF0000FF
8 6 2 0xFF0000FF
9 6 2 0xFF0000FF
0 7 2 0x00FF00FF
1 7 2 0x00FF00FF
2 7 2 0x00FF00FF
3 7 2 0x00FF00FF
4 7 2 0x00FF00FF
5 7 2 0x00FF00FF
6 7 2 0x00FF00FF
7 7 2 0x00FF00FF
8 7 2 0x00FF00FF
9 7 2 0x00FF00FF