triangle
6 6
0 0 4 0xFF0000FF
1 0 4 0xFF0000FF
2 0 4 0xFF0000FF
3 0 4 0xFF0000FF
4 0 4 0xFF0000FF
5 0 4 0xFF0000FF
1 1 4 0x00FF00FF
2 1 4 0x00FF00FF
3 1 4 0x00FF00FF
4 1 4 0x00FF00FF
5 1 4 0x00FF00FF
0 2 4 0x0000FFFF
1 2 4 0x0000FFFF
2 2 4 0x0000FFFF
3 2 4 0x0000FFFF
4 2 4 0x0000FFFF
5 2 4 0x0000FFFF
1 3 4 0xFF0000FF
2 3 4 0xFF0000FF
3 3 4 0xFF0000FF
4 3 4 0xFF0000FF
5 3 4 0xFF0000FF
0 4 4 0x00FF00FF
1 4 4 0x00FF00FF
2 4 4 0x00FF00FF
3 4 4 0x00FF00FF
4 4 4 0x00FF00FF
5 4 4 0x00FF00FF
1 5 4 0x0000FFFF
2 5 4 0x0000FFFF
3 5 4 0x0000FFFF
4 5 4 0x0000FFFF
5 5 4 0x0000FFFF
0 6 4 0xFF0000FF
1 6 4 0xFF0000FF
2 6 4 0xFF0000FF
3 6 4 0xFF0000FF
4 6 4 0xFF0000FF
5 6 4 0xFF0000FF